11111111111111111111111111111111
1P0000000000000000C0000000000001
11111111111111111111111111111101
10000000000C00000000000000000101
10101111111111111111011111110101
1010100000000C000000010000010101
10101011111111111111010101110101
101010100000000000010101000101C1
10101010111111111110101010110101
1C1010101E00000C0000000000000101
10101010101111111111010101011101
10101010101000000001010100000101
10101010101011111111010101111101
1010101010101000000101010000C101
10011111111111111111111111111101
10000000000000C000000000000000C1
11111111111111111111111111111111
