1111111
1E10C01
101C0E1
1110C01
1P1C001
1010001
1111111
