111111111111111111111111111111111111111111
10000C0000C0000C00000000000000000000000001
100000000000000000000000000000000000000001
100001111C10000000000000000000000000000001
100000P00000000000000000000000000000000001
100000000000000000000000000000000E00000001
100E00000000000000000000000000000000000001
10000111000000000C000000000000000000000001
111111111111111111111111111111111111111111
