11111111111111111111
1000C0010000110000C1
101001010010C001E111
10100100101010011111
1P0001000C10100000C1
11111111111111111111
